#
barostat             	on
barostatpressure     	1.01325
extendedsystem          ../1-equil/output.xsc
bincoordinates          ../1-equil/output.coor
cutoff               	9
parmfile             	../0-build/cpx.prmtop
pme                  	on
restart              	on
#structure            	../0-build/cpx.pdb
switchdistance       	7.5
switching            	on
temperature          	300
thermostat           	on
thermostatdamping    	1
thermostattemperature	300
timestep             	4
trajectoryfile       	output.xtc
trajectoryperiod     	2500
run                  	15000
